# #############
#             #
#####  ########
#        #    #
#  #######    #
#             O
########  #####
       #  #
       ####